#######################################
# supremeDuck coloring
#######################################

#######################################
# Datatypes (KEYWORD1)
#######################################
Protocol		KEYWORD1
WirelessModule		KEYWORD1
Esp8266		KEYWORD1
JDY		KEYWORD1
HC_Bluetooth		KEYWORD1
ser		KEYWORD1

#######################################
# Methods and Functions (KEYWORD2)
#######################################

Check	KEYWORD2
IsItTimeTo_ReleaseAltTab	KEYWORD2
ReleaseAltTab	KEYWORD2
AltTabOnce	KEYWORD2
dbg	KEYWORD2
Receive	KEYWORD2
EnterProgrammingMode	KEYWORD2
Handshake	KEYWORD2
Send	KEYWORD2
ChangeNameAndPasswordIfRequested	KEYWORD2
WasNameChangeRequested	KEYWORD2
WasPasswordChangeRequested	KEYWORD2
ChangeName	KEYWORD2
ChangePassword	KEYWORD2
ResetNameChangeRequestFlag	KEYWORD2
ResetPasswordChangeRequestFlag	KEYWORD2

##############################
# File: Keyboard.h

PressAndWait	KEYWORD2
PressRaw	KEYWORD2
ReleaseRaw	KEYWORD2
PressRawModifier	KEYWORD2
ReleaseRawModifier	KEYWORD2
Print	KEYWORD2
SetDefaultDelay	KEYWORD2
GetDefaultDelay	KEYWORD2
SetKeypressTime	KEYWORD2
GetKeypressTime	KEYWORD2
IsUsingAltCodes	KEYWORD2
UseAltCodes	KEYWORD2
LoadAltCodesUseState	KEYWORD2
GetEncodingName	KEYWORD2
SetEncodingName	KEYWORD2
WasEncodingPreviouslySaved	KEYWORD2
LoadEncoding	KEYWORD2
SetEncoding	KEYWORD2


#######################################
# Constants (LITERAL1)
#######################################


###################
# File: Esp8266.h
ESP_MODE_WORKING	LITERAL1
ESP_MODE_PROGRAMMING	LITERAL1

###################
# File: Definitions.h

EEPROM_SAVED_ENCODING_AVAILABLE_ID	LITERAL1
WAIT_FOR_SERIAL_MONITOR_TO_OPEN	LITERAL1
DEBUG	LITERAL1
WIFI_DUCKY_SETUP	LITERAL1
JDY_10_SETUP	LITERAL1
JDY_08_SETUP	LITERAL1
PROGRAMMING_MODE_SWITCH_PIN	LITERAL1
WIFI_DUCKY_GPIO_0_CONTROL_PIN	LITERAL1
WIFI_DUCKY_ENABLE_CONTROL_PIN	LITERAL1
USE_TX_RX_PINS	LITERAL1
MODULE_BAUDRATE	LITERAL1
MODULE_BAUDRATE	LITERAL1
WIRELESS_MODULE_SERIAL	LITERAL1
WIRELESS_MODULE_SERIAL	LITERAL1
MAX_SERIAL_LENGTH	LITERAL1
ALT_TAB_AUTORELEASE	LITERAL1
LED_SHOW_ACTIVITY_TIME	LITERAL1
EEPROM_ADDRESS_REQUESTED_BLE_NAME_CHANGE	LITERAL1
EEPROM_ADDRESS_REQUESTED_BLE_PIN_CHANGE	LITERAL1
EEPROM_ADDRESS_REQUESTED_BLUETOOTH_NAME_CHANGE	LITERAL1
EEPROM_ADDRESS_REQUESTED_BLUETOOTH_PIN_CHANGE	LITERAL1
EEPROM_ADDRESS_BLUETOOTH_NAME	LITERAL1
BLUETOOTH_NAME_SIZE	LITERAL1
EEPROM_ADDRESS_BLUETOOTH_PIN	LITERAL1
EEPROM_ADDRESS_BLE_NAME	LITERAL1
EEPROM_ADDRESS_BLE_PIN	LITERAL1
BLE_NAME_SIZE	LITERAL1
EEPROM_ADDRESS_ENCODING_AVAILABLE	LITERAL1
EEPROM_STARTING_ADDRESS_ENCODING_DESIRED	LITERAL1
EEPROM_STARTING_ADDRESS_ENCODING_USED	LITERAL1
EEPROM_STARTING_ADDRESS_ENCODING_MODIFIER	LITERAL1
EEPROM_ADDRESS_USE_MULTI_LANG_METHOD_WINDOWS	LITERAL1
EEPROM_STARTING_ADDRESS_ENCODING_NAME	LITERAL1
ENCODING_NAME_SIZE	LITERAL1
EEPROM_CHANGE_REQUESTED_ID	LITERAL1
ENCODING_BYTE_DESIRED	LITERAL1
ENCODING_BYTE_USED	LITERAL1
ENCODING_BYTE_MODIFIER	LITERAL1
ENCODING_SIZE	LITERAL1


###################
# File: Keyboard.h
EXCEPTIONS_SIZE	LITERAL1

###################
# File: supremeDuck.ino
APP_Version	LITERAL1

###################
# File: Funcs.cpp
DBG_PREFIX	LITERAL1
DBG_SUFFIX	LITERAL1

